先週　- senshuu - weekend
周り - まわり - circunference
トピック - topic
自己紹介 -  じこしょうかい - self introduction
自分 - themselves
紹介 - しょうかい - introduction
職場 -  しょくば - place of workc
役割 -  やくわり - roles
理解 -  りかい - to understand
新入社員 -  しんにゅうしゃいん - new hire
働く - to work
主任 -  しゅにん - boss
tetsuzuki
中国出身 -  しゅっしん - origen
生活 -  せいかつ
担当 -  たんとう - being responsable of
確認 -  かくにん - to confirm
一生懸命 -  いっしょうけんめい
順番 -  じゅんばん  - order of things, sequential order
呼び方 -  よびかた - way of calling
経験 -  けいけん - experience
学習経験 -  がくしゅう keiken - study experience
横 - よこ - de lado
設定 -  せってい - establecimiento, setting
方角 -  ほうがく - direction
自然 -  しぜん - nature
島 - しま - island
草原 -  そうげん  - grassy field
砂漠 -  さばく
高原 -  こうげん
出身地 -  しゅっしんち  - birth place
首都 -  しゅと  - capital city
観光地 -  かんこうち - tourist attraction　
出席
教室
休み時間
出来る
出る
聞く
初級
第
課
初めて
それぞれ
聞くといい
パートタイム
略
会社
手続き
準備
去年